111111111111111111
140000000630000001
100250100000000051
100022220000022221
100000020000000001
100000000000000001
100000000077700001
100022200000000001
100000000002222221
140000000000000041
111111111111111111